R  800 500
NO    ./src/textures/wall_n.xpm
SO    ./src/textures/wall_s.xpm
EA   ./src/textures/wall_e.xpm 
WE	 ./src/textures/wall_w.xpm	
S ./src/textures/Blastoise.xpm

F 220,220,220
C 0,30,255

1111
11001
10001
10201
10001
10001111
10N01
 111