R  800 500
NO    ./src/textures/wall_n.xpm
SO    ./src/textures/wall_s.xpm
EA   ./src/textures/wall_e.xpm 
WE	 ./src/textures/wall_w.xpm	
S ./src/textures/Blastoise.xpm

F 220,220,220
C 0,30,255

11111111111111111 11111111
      1000000000110000000001111
      1000000000000000000011111
   111000000110000000000001
   1000110000000010000000001
   1000000000000000000000001
    100000000001S001110000001
   1000000000000000000000001
   1000000000020000000000001
   1000000001111100000000001
   1000000000000000000000001
   1000000000000001110000001
   1001111100000000000000001
   1000000000000002000000001
   1000000000000000000000001
   1111111111111111111111111