R 800 600
NO ./src/textures/Gold1.xpm

SO ./src/textures/bookshelf.xpm
WE ./src/textures/GlassFacete.xpm
EA ./src/textures/Bricks.xpm
S ./src/textures/Blastoise.xpm

C 79,0,45

111111111111111
100000000000001
100S001111111111111111
1000001000000000000001
1000000000000000000001
1000000000000000000001
1000000000000000000001
1000000000000000000001
1000000000000000000001
1000000000000000000001
1000000000000000000001
1000001200000000000001
1111111111111111111111
